....................
....................
....................
...##...............
....................
............##......
...................
....................
...###..............
....................
...........##.......
....................
....@............###
####################
....................