....................
....................
...%...............
...##.......#.......
........#...........
....#.......##......
##.................
..............#.....
...###........#....#
.............###
.....#..............
.@.............###
###########################
....................