....................
....................
...E...............
...##.......#.......
....S...#...........
....#.......##......
##.................
..............#.....
...###........#....#
.............###
.....#..............
.P.............###
###########################
....................