....................
....................
....................
...##...............
....................
....................
...................
....................
...##...............
...........##.......
....................
....................
....@...............
####################
....................