....................
....................
....................
........S...........
....................
...................
..##................
....................
.......##...........
....................
.............##.....
....................
.........##......
.................
....##...........
................
#...............
.#.................
....................
..#................
....................
.......##...........
....................
.............##.....
....................
.........##......###
.................###
....##...........###
.................#..
#P...............#.E
####################
