....................
....................
.............##.....
....................
.........##......###
.................###
....##...........###
.................#..
#@...............#.%
####################
