....................
....................
.............##.....
....................
.........##......#..
.................#..
....##...........#..
.................#..
#@...............#.%
####################
